9 7
#########
#   #   #
# P #   #
##     ##
# #   # #
#       #
#########