10 10
##########
#   #    #
###  P  ##
#        #
##  i  # #
##    ## #
## ## ## #
## ## ## #
##     i #
##########