10 10
##########
#   #    #
###  P  ##
#   #    #
######## #
##    ## #
## ## ## #
## ## ## #
##       #
##########